6 6 6 6 5 5 5 5 5 0 0 0 0 0 0 0 
6 6 6 6 5 5 5 5 5 0 0 0 3 3 0 0 
6 6 6 6 5 2 5 5 5 0 4 3 0 0 3 4 
6 6 6 6 5 5 5 5 5 0 3 0 0 0 0 3 
6 6 6 6 5 5 5 5 5 0 3 0 0 4 0 3 
6 6 6 6 5 5 5 5 5 0 3 0 0 0 0 3 
6 1 1 1 5 5 5 2 5 1 3 4 0 0 0 3 
6 6 6 6 2 5 5 5 5 0 3 0 0 0 0 3 
6 6 6 6 5 5 5 5 2 0 3 0 0 0 0 3 
6 6 6 6 5 5 5 5 5 0 3 0 0 0 0 3 
6 6 6 6 5 5 2 5 5 0 3 3 1 1 3 3 
6 6 6 6 5 0 5 5 5 0 3 3 1 1 3 3 
